년도,평균(천원),정규직근로자,비정규직근로자,파견/용역근로자,일일근로자,단시간근로자,기간제근로자
2007,1847,2027,1145,1144,1219,616,1425
2008,1945,2151,1189,1227,1268,643,1499
2009,1960,2199,1202,1263,1272,645,1511
2010,2023,2285,1219,1306,1255,653,1585
2011,2102,2385,1282,1390,1355,677,1690
2012,2216,2502,1313,1434,1375,692,1732
2013,2288,2566,1372,1540,1459,707,1900
